11111111111111111111111111
110C1000000000000000000001
10011011111111111111111101
10111010000C111C111C00C101
100000001110000011100001E1
10001101111011111111110111
111111011000111110000000C1
10001C0110101C001011111101
10100000001011100010010001
10111111111010001111011001111
1P000000000000100000000001
11111111111111111111111111