11111111111111111111111111
10000000000000E00000000001
10000000000000000000000001
10000000000000000010000001
1000C00000000000000C000001
10000000000000000000000111
1000000001000000C000000101
10E00000000000000000000111
1000000P00000000000C000001
10000000000000000000000001
10000000000000000000000001
11111111111111111111111111