11111111111
100000C0001
1000P000000
10000000001
100E0000001
11111111111