11111111111111111111111111
10000000000000E00000000001
10000000000000000000000001
10000000000000000010000001
10000000000000000000000001
10000000000000000000000111
10000000010000000000000101
10E00000000000000000000111
1000000P000000000000000001
10000000000000000000000001
10000000000000000000000001
11111111111111111111111111