11111111111
100000C0001
1000P000001
10000000001
100E0011111
1000001
1111111